=============================================
==  K                                      ==
==                                         ==
==  M                                      ==
==                                         ==
==  W                                      ==
==                                         ==
==  T                                      ==
==                                         ==
==                                         ==
==                                         ==
==                                         ==
==                                         ==
==                                         ==
==                                         ==
==                                         ==
==                                         ==
==                                         ==
==                                         ==
=============================================
