=============================================
==                                         ==
==                                         ==
==                                         ==
==                                         ==
==                                         ==
==                                         ==
==                                         ==
==                                         ==
==                                         ==
==                                         ==
==                                         ==
==                                         ==
==                                         ==
==                                         ==
==                                         ==
==                                         ==
==                                         ==
==          K   M    W      T              ==
=============================================
