=============================================
==         K   M    W      T               ==
==                                         ==
==                                         ==
==                                         ==
==                                         ==
==                                         ==
==                                         ==
==                                         ==
==                                         ==
==                                         ==
==                                         ==
==                                         ==
==                                         ==
==                                         ==
==                                         ==
==                                         ==
==                                         ==
==                                         ==
=============================================
